```
Fruit and Drinks and the Future Tense (tomorrow)

Matunda - Fruits
Ndimũ - Lemon
Ĩembe/Maembe - Mango
Ikorobia/Makorobia - Avocado
Itomoko/Matomoko - Custard apple
Inanathi/mananathi - Pineapple
Mabera - Guava
Irĩgũ rĩrũ/Marĩgũ meru - ripe bananas
Ĩbabaĩ/mababaĩ - Pawpaw
Ndare - African berry
Nathi - goose berry
Thandara - Tangerine
Ĩcungwa - Orange

 Ndare - African berry (Synsepalum dulcificum)
 Nathi - goose berry (physalis angulata)

Cama - Taste
kũgagata - to have sour taste
Mũrio - sweet taste
Kũrũra - to have a bitter
Bĩrĩbĩrĩ nĩ ndũrũ - pepper is bitter
Cukari - sugar
Cumbĩ - salt
Kũrũra cukari - over sweetened
Kũrũra cumbĩ - over salted
Mũrĩo wa ũkĩ - sweetness of honey

Learn Kikuyu – Wĩrute Gĩkũyũ - Jifunze Kikuyu
© Emmanuel Kariuki
```